NO ./textures/north.xpm
SO ./textures/south.xpm
WE ./textures/west.xpm
EA ./textures/east.xpm


F 220,100,0
C 225,30,0

1111111
1000111
10011111
1000N1
11111 11
