NO ../Textures_xpm/Planet1.xpm
SO ../Textures_xpm/Planet2.xpm
EA 		../Textures_xpm/Planet3.xpm
WE ../Textures_xpm/Planet4.xpm


F 1,200,0
C 4,5  ,0 

11111 
10001
1001111111111
1S00000000001
1111111111111


