NO ../Textures_xpm/Planet1.xpm
SO ../Textures_xpm/Planet2.xpm
EA 		../Textures_xpm/Planet3.xpm
WE ../Textures_xpm/Planet4.xpm


F 1,200,0
C 4,5  ,0 

11111 
10001
1001111111111
100000W000001		
11111111111111111
11111	11111111				1111
101
101
111






