NO textures/Wall.png
SO textures/Wall.png
WE textures/Wall.png
EA textures/wall.png

F  220,100,0
C  225,30,0



        1111111111111111111111111
        1000000000110000000000001
        1011000001110000000000001
        1001000000000000000000001
111111111011000001110000000000001
100000000011000001110111110111111
11110111111111011100000010001
11110111111111011101010010001
11000000110101011110000001001
10000000000000001100000010001
10000000000000001101010010001
110000011101010111110111N00011
11110111 10110101 111110100011
11111111 1111111 111111111111