NO textures/Wall.png
SO textures/Wall.png
WE textures/Wall.png
EA textures/wall.png

F 85, 118, 86
C 125, 144, 5



111111
100101
101001
1100N1
111111
